Dial Color: Black, Case Shape: Rectangular, Dial Glass material: Mineral
Band Color: Black, Band Material: Resin, Occasion: Sports
Watch Movement Type: Quartz, Watch Display Type: Analog-Digital
Case Material: Resin, Buckle Clasp
Warranty type:Manufacturer; 2 Years Domestic Warranty
Remove plastic at crown to start the watchBand Colour	Black
Band Material	Resin
Band Width	20 Millimeters
Brand	Casio
Calendar Type&#65279;	Day-Date-Month
Case Diameter	5.5 Centimeters
Case Material	Resin
Case Thickness	11 Millimeters
Clasp&#65279;	Tang Buckle
Collection	G-Shock
Dial Colour	Black
Crystal Material&#65279;	Mineral
Display Type	Analog-Digital
Case Shape	Round
Item Weight	72 Grams
Model Number	GA-110-1BDR (G317)